0 0 0 0 0 0 0 0 0 0 0 0 0 0 0 0 0 0 0 0 0 0 0 0 0 0 0 0
0 0 0 0 0 0 0 0 0 0 0 0 0 0 0 0 0 0 0 0 0 0 0 0 0 0 0 0
0 0 0 0 0 0 0 0 0 0 0 0 0 0 0 0 0 0 0 0 0 0 0 0 0 0 0 0
/ = = = = = = = = = = = = ] [ = = = = = = = = = = = = \
( f f f f f f f f f f f f } { f f f f f f f f f f f f )
( f 4 _ _ 1 f 4 _ _ _ 1 f } { f 4 _ _ _ 1 f 4 _ _ 1 f )
( f { 0 0 } f { 0 0 0 } f } { f { 0 0 0 } f { 0 0 } f )
( f 3 - - 2 f 3 - - - 2 f 3 2 f 3 - - - 2 f 3 - - 2 f )
( f f f f f f f f f f f f f f f f f f f f f f f f f f )
( f 4 _ _ 1 f 4 1 f 4 _ _ _ _ _ _ 1 f 4 1 f 4 _ _ 1 f )
( f 3 - - 2 f } { f 3 - - 5 6 - - 2 f } { f 3 - - 2 f )
( f f f f f f } { f f f f } { f f f f } { f f f f f f )
é . . . . 1 f } 7 _ _ 1 0 } { 0 4 _ _ 8 { f 4 . . . . è
0 0 0 0 0 { f } 6 - - 2 0 3 2 0 3 - - 5 { f ) 0 0 0 0 0
0 0 0 0 0 { f } { 0 0 0 0 0 0 0 0 0 0 } { f ) 0 0 0 0 0
0 0 0 0 0 { f } { 0 u . . G G . . i 0 } { f ) 0 0 0 0 0
= = = = = 2 f 3 2 0 ) 0 0 0 0 0 0 ( 0 3 2 f 3 = = = = =
0 0 0 0 0 0 f 0 0 0 ) 0 0 0 0 0 0 ( 0 0 0 f 0 0 0 0 0 0
. . . . . 1 f 4 1 0 ) 0 0 0 0 0 0 ( 0 4 1 f 4 . . . . .
0 0 0 0 0 { f } { 0 o = = = = = = j 0 } { f ) 0 0 0 0 0
0 0 0 0 0 { f } { 0 0 0 0 0 0 0 0 0 0 } { f ) 0 0 0 0 0
0 0 0 0 0 { f } { 0 4 _ _ _ _ _ _ 1 0 } { f ) 0 0 0 0 0
/ = = = = 2 f 3 2 0 3 - - 5 6 - - 2 0 3 2 f 3 = = = = \
( f f f f f f f f f f f f } { f f f f f f f f f f f f )
( f 4 _ _ 1 f 4 _ _ _ 1 f } { f 4 _ _ _ 1 f 4 _ _ 1 f )
( f 3 - 5 { f 3 - - - 2 f 3 2 f 3 - - - 2 f } 6 - 2 f )
( f f f } { f f f f f f f 0 P f f f f f f f } { f f f )
a _ 1 f } { f 4 1 f 4 _ _ _ _ _ _ 1 f 4 1 f } { f 4 _ c
b - 2 f 3 2 f } { f 3 - - 5 6 - - 2 f } { f 3 2 f 3 - d
( f f f f f f } { f f f f } { f f f f } { f f f f f f )
( f 4 - - - - 2 3 - - 1 f } { f 4 - - 2 3 - - - - 1 f )
( f 3 _ _ _ _ _ _ _ _ 2 f 3 2 f 3 _ _ _ _ _ _ _ _ 2 f )
( f f f f f f f f f f f f f f f f f f f f f f f f f f )
é . . . . . . . . . . . . . . . . . . . . . . . . . . è
0 0 0 0 0 0 0 0 0 0 0 0 0 0 0 0 0 0 0 0 0 0 0 0 0 0 0 0
0 0 0 0 0 0 0 0 0 0 0 0 0 0 0 0 0 0 0 0 0 0 0 0 0 0 0 0