0 0 0 0 0 0 0 0 0 0 0 0 0 0 0 0 0 0 0 0 0 0 0 0 0 0 0 0
0 0 0 0 0 0 0 0 0 0 0 0 0 0 0 0 0 0 0 0 0 0 0 0 0 0 0 0
0 0 0 0 0 0 0 0 0 0 0 0 0 0 0 0 0 0 0 0 0 0 0 0 0 0 0 0
/ = = = = = = = = = = = = ] [ = = = = = = = = = = = = \
( 0 0 0 0 0 0 0 0 0 0 0 0 } { 0 0 0 0 0 0 0 0 0 0 0 0 )
( 0 4 _ _ 1 0 4 _ _ _ 1 0 } { 0 4 _ _ _ 1 0 4 _ _ 1 0 )
( 0 { 0 0 } 0 { 0 0 0 } 0 } { 0 { 0 0 0 } 0 { 0 0 } 0 )
( 0 3 - - 2 0 3 - - - 2 0 3 2 0 3 - - - 2 0 3 - - 2 0 )
( 0 0 0 0 0 0 0 0 0 0 0 0 0 0 0 0 0 0 0 0 0 0 0 0 0 0 )
( 0 4 _ _ 1 0 4 1 0 4 _ _ _ _ _ _ 1 0 4 1 0 4 _ _ 1 0 )
( 0 3 - - 2 0 } { 0 3 - - 5 6 - - 2 0 } { 0 3 - - 2 0 )
( 0 0 0 0 0 0 } { 0 0 0 0 } { 0 0 0 0 } { 0 0 0 0 0 0 )
é . . . . 1 0 } 7 _ _ 1 0 } { 0 4 _ _ 8 { 0 4 . . . . è
0 0 0 0 0 { 0 } 6 - - 2 0 3 2 0 3 - - 5 { 0 ) 0 0 0 0 0
0 0 0 0 0 { 0 } { 0 0 0 0 0 0 0 0 0 0 } { 0 ) 0 0 0 0 0
0 0 0 0 0 { 0 } { 0 u . . G G . . i 0 } { 0 ) 0 0 0 0 0
= = = = = 2 0 3 2 0 ) 0 0 0 0 0 0 ( 0 3 2 0 3 = = = = =
0 0 0 0 0 0 0 0 0 0 ) 0 0 0 0 0 0 ( 0 0 0 0 0 0 0 0 0 0
. . . . . 1 0 4 1 0 ) 0 0 0 0 0 0 ( 0 4 1 0 4 . . . . .
0 0 0 0 0 { 0 } { 0 p = = = = = = j 0 } { 0 ) 0 0 0 0 0
0 0 0 0 0 { 0 } { 0 0 0 0 0 0 0 0 0 0 } { 0 ) 0 0 0 0 0
0 0 0 0 0 { 0 } { 0 4 _ _ _ _ _ _ 1 0 } { 0 ) 0 0 0 0 0
/ = = = = 2 0 3 2 0 3 - - 5 6 - - 2 0 3 2 0 3 = = = = \
( 0 0 0 0 0 0 0 0 0 0 0 0 } { 0 0 0 0 0 0 0 0 0 0 0 0 )
( 0 0 0 0 0 0 4 _ _ _ 1 0 } { 0 4 _ _ _ 1 0 4 _ _ 1 0 )
( 0 4 _ _ 1 0 3 - - - 2 0 3 2 0 3 - - - 2 0 } 6 - 2 0 )
( 0 3 - 5 { 0 0 0 0 0 0 0 0 0 0 0 0 0 0 0 0 } { 0 0 0 )
a _ 1 0 } { 0 4 1 0 4 _ _ _ _ _ _ 1 0 4 1 0 } { 0 4 _ c
b - 2 0 } { 0 } { 0 3 - - 5 6 - - 2 0 } { 0 3 2 0 3 - d
( 0 0 0 3 2 0 } { 0 0 0 0 } { 0 0 0 0 } { 0 0 0 0 0 0 )
( 0 4 - - - - 2 3 - - 1 0 } { 0 4 - - 2 3 - - - - 1 0 )
( 0 3 _ _ _ _ _ _ _ _ 2 0 3 2 0 3 _ _ _ _ _ _ _ _ 2 0 )
( 0 0 0 0 0 0 0 0 0 0 0 0 0 0 0 0 0 0 0 0 0 0 0 0 0 0 )
é . . . . . . . . . . . . . . . . . . . . . . . . . . è
0 0 0 0 0 0 0 0 0 0 0 0 0 0 0 0 0 0 0 0 0 0 0 0 0 0 0 0
0 0 0 0 0 0 0 0 0 0 0 0 0 0 0 0 0 0 0 0 0 0 0 0 0 0 0 0